SO   textures/greystone.xpm
NO    textures/eagle.xpm
EA textures/red.xpm   
WE textures/purplestone.xpm     

F 40,11ss3,39
C 89,198,227

1111111111111111
1000000000000001
1000100000001001
10000000N0000001
1000100000001001
1000000000000001
1111111111111111