SO textures/greystone.xpm
NO textures/eagle.xpm
EA textures/red.xpm
WE textures/purplestone.xpm

F 40,113,39
C 89,198,227

1111111111111111
10e000000000a001
1000100000001001
1000s0000N000001
1000100000001001
1000000000000001
1111111111111111