F 40,113,3944444
SO   textures/greystone.xpm
NO    textures/eagle.xpm
EA textures/red.xpm   

WE textures/purplestone.xpm     

C 89,198,227
 111111
1N111111
 1000001
111111111