F 40,113,39
SO   textures/greystone.xpm
NO textures/eagle.xpm
EA textures/red.xpm   

C      89    ,198,227

WE textures/purplestone.xpm     


111111
1111N1     1
111111
      11111
          1
1        101
11        1
