F 40,113,39
SO   textures/greystone.xpm
NO    textures/eagle.xpm
EA textures/red.xpm   

WE textures/purplestone.xpm     

C 89,198,227
 111111
1001111   1111    11
100N0001    1011  101
111111111  111     1